,---------------------------------------.---------.    
|                                       |         |    
|    ,-----------------------------.    |    .    |    
|    |                             |    |    |    |    
|    |    ,-------------------.    |    |    |    |    
|    |    |                   |    |    |    |    |    
|    |    `----     ,----     |    |    |    |    |    
|    |              |         |    |    |    |    |    
|    |    ,---------"---------:    |    `----'    |    
|    |    |                   |    |              |    
|    `----:    ,---------.    |    `---------.    |    
|         |    |         |    |              |    |    
|    .    |    |    .    |    |     ---------'    |    
|    |    |    |    |    |    |                   |    
:----'    |    |    |    |    |    ,--------------:    
|         |    |    |    |    |    |              |    
|    .    |    `----'    |    |    |     ----.    |    
|    |    |              |    |    |         |    |                                        
|    `----"---------     |    |    `---------'    |    
|                        |    |                   |    
`------------------------'    `-------------------'